#####################
S_#_______#___#___#_#
#_#####_###_#_###_#_#
#_#_____#___#_____#_#
#_#_#_###_#_##_####_#
#___#_____#_______#_#
#_#_###_####_####_#_#
#_#___#___#___#_#___#
#_###_###_###_#_###_#
#_____#___#___#___#_#
##_####_###_#####_#_#
#_____#_#___#___#_#_#
#_###_#_#_#_###_#_#_#
#_#_#___#_#___#_#_#_#
#_#_#####_#_#_#_#_#_#
#_#___#___#_#___#_#_#
#_#_#_#_###_##_##_###
#_#_#_#___#_#___#___#
#_#_#_#_#_#_#_#_###_#
#___#___#_____#_____G
#####################