####################
#S_________________#
#_###_#######_####_#
#_#______________#_#
#_#_#_#######_##_#_#
#_#_#__________#_#_#
#_#_#_###_##_#_###_#
#___#___#_#__#_____#
#_#_#_###_##_#_###_#
#_#_#_#____#_#_###_#
#_#_#___##G###_#___#
#_#_###_##_____#_#_#
#_#_###____#####_#_#
#_#___####_#####_#_#
#_###______________#
#_###_########_#_#_#
#_______#________#_#
#_###_###_########_#
#__________________#
####################